NO ./assets/textures/wall01.xpm
SO ./assets/textures/wall02.xpm
WE ./assets/textures/wall03.xpm
EA ./assets/textures/wall04.xpm

F 173,116,230
C 144,138,144

111111111111111111111111111111111
10000000000000000000000000LLLLLL1
100E0000000000000D00000000LLLLLL1
10000000000000000000000000LLLLLL1
111111111100000000000111111111111
         10000000D0001
1111111111000000000001
1000000000000D00000001
1000000000000000000001
1000000000000000000001
1111111111000000000001
         1000000000001
         11110000011111111111111111
         10000000000000000000000001
         1000000D00000000000000D001
         10000000000000000000000001
         10000000000011111111111111
         1000000000001
         1000000000001
         1000000000001
         1000000000001
         1000000000001
         1000000000001
         1000000000001
         1000000000001
         1000000000001
         1000000000001
         1000000000001
         1000000000001
         1111111111111
