111111111111111111111111111111111
100000000000000000000000000000001
100000000000000000000000000000001
111111111100000S000001111111111111
         10000000000010000000001
         100000000000111111111111
         100000000000100000000001
         1111100011111111111111111
         1000000000000000000000001
         1000000000000000000000001
11111    1111111111111111111111111
10001
101
1001
101
11
1
1
1
1
11
101
1001
1001
111                1111111111
                11111
 1111111111
10000000001
1111111111
