111111111111111111111111111111111
100000000000000000000000000000001
100000000000000000000000000000001
111111111100000S00000111111111111
         1000000000001
         1000000000001
         1000000000001
         1111100011111111111111111
         1000000000000000000000001
         1000000000000000000000001
         1111111111111111111111111
