NO ./assets/textures/wall01.xpm
SO ./assets/textures/wall02.xpm
WE ./assets/textures/wall03.xpm
EA ./assets/textures/wall04.xpm

F 220,100,0
C 225,30,0

111111111111111111111111111
1S0000000000G00000000000001
111110111111011111111011111
1D0000000001000000000B00001
101111011110111111111011111
1G000010D0010000B00001000B1
111101111110111111101111111
1L0000100001000000000000001
101110111111011111111110111
1D0000000000L0000000L000001
111110111110111111111110111
1B0000L0001000000000L000001
101111111110111111111011111
1D0000G0001000000000G000001
111111111111111111111111L11
1D0000000000L000000000000L1
111111111111111111111111111
