NO ./assets/textures/wall01.xpm
SO ./assets/textures/wall02.xpm
WE ./assets/textures/wall03.xpm
EA ./assets/textures/wall04.xpm

F 173,216,230
C 144,238,144

       1111111111111
       1S0000000G001
    1111011111101101
    1D001000B0000011
1111101011101111011
1G000010D00001000B1
1011111110111111011
1L0000100000000001
 11011101111111011
   1D0000000L0001
111101111011110111
1B0000L0000000001
 1011111101111111
 1D0000G00000001
  1111111111111
