NO ./assets/textures/wall01.xpm
SO ./assets/textures/wall02.xpm
WE ./assets/textures/wall03.xpm
EA ./assets/textures/wall04.xpm

F 173,216,230
C 144,238,144
                                11111111111
                                10000000001
                                10000000001
                                10000000001
111111111111111111111111111111111111G1111111111111111111111111111111111111111111111
10000010000010000000100B00100000000000000000001000000010000000000000000000000000001
1000D01000001000D000100000100000D00000000D000010000000100000D00000000000D0000000001
1E0000G00D00G0000000G00000G0000000000000000000G0000000G0000000000000000000000000001
1000001000001000D0001000001000000000D00000000010000000100000000000D00000000000D0001
1000D010000010000000100D00100000000000000000001000000010000000000000000000000000001
111111111111111111111111111111111111G111111111111LLL1111111111111111111111111111111
                          100000000000000000001 11111
                          111111110000011111111
                                 1000001
                                 1111111
