NO ./assets/textures/wall01.xpm
SO ./assets/textures/wall02.xpm
WE ./assets/textures/wall03.xpm
EA ./assets/textures/wall04.xpm

F 173,216,230
C 144,238,144

          11111111111          
        111000000000111        
      1100000D00000000L1       
     1S0000000G0000000001      
     110110111111011110111     
     1D0001000000000B00001     
    11010111111011111110111    
    1L0000100001000000000L1    
     110111111111011111111     
     1D0000000000000B0001      
     1B000000L0000000D0001     
      11011101111011110111     
       1D000G0000000000001     
       1111111111111111111     
