NO ./assets/textures/wall01.xpm
SO ./assets/textures/wall02.xpm
WE ./assets/textures/wall03.xpm
EA ./assets/textures/wall04.xpm

F 173,216,230
C 144,238,144


                                     11111111111
                                     10000000001
                                     10000D00001
                                     10000000001
111111111111111111111111111111111111111111G11111111111111111111111111
10000D100000000000001000000000001000000000000000000010000000000000001
10000B10000000000000100000000D001000000000000000000010000000000000001
1E0000G00D0000000000G00000D00B00G000000000B000000000G0000000000000001
10000B100000000000001000000000001000000000000000000010000000D00000001
10000D100000000000001000000000001000000000000000000010000000000000001
11111111111111111111111111111111111111111GGG1111111111111111111111111
                                100000000000000000001
                                100D00000000000000001
                                100000000000000000001
                                111111110000011111111
                                       1LLLLL1
                                       1111111
