1111111111
1000000001
1000S00001
1000000001
1000000001
1000D00001
1000000001
1000000001
1000000001
1000LL0001
1111111111
