NO ./assets/textures/wall01.xpm
SO ./assets/textures/wall02.xpm
WE ./assets/textures/wall03.xpm
EA ./assets/textures/wall04.xpm

F 173,216,230
C 144,238,144

1111111111
1000000001
1000000001S
1000000001
1000000001
1000100001
1000000001
1000000001
1000000001
1000000001
1000000001
1111111111
