111111111111111111111111111111111
100000000D0000000000000000LLLLLL1
100E0000000000000D00000000LLLLLL1
100000000000D0000000000000LLLLLL1
111111111100000000000111111111111
         10000000D0001
1111111111000000000001
1000000000000000000001
1000000000000000000001
1000000000000000000001
1111111111000000000001
         1000000000001
         11110000011111111111111111
         10000000000000000000000001
         10000000000000000000000001
         10000000000000000000000001
         10000000000011111111111111
         1000000000001
         1000LLLLL0001
         1000LLLLL0001
         1000LLLLL0001
         1000000000001
         1000000000001
         1000000000001
         1000000000001
         1000000000001
         1000000000001
         1000000000001
         1000000000001
         1111111111111
