111111111111111111111111111111111
10000000000000000000000000LLLLLL1
100E0000000000000D00000000LLLLLL1
10000000000000000000000000LLLLLL1
111101000000000000000111111111111
   10100000000000D0001
1111011111000000000001
1000000001000D00000001
1000D00001000000000001
1000000001000000000001
1111111111000000000001
         1000000000001
         11110000011111111111111111
         10000000000000000000000001
         1000000D00000000000000D001
         10000000000000000000000001
         10000000000011111111111111
         1000000000001
         1000000000001
         1000000000001
         1000000000001
         1000000000001
         1000000000001
         1000000000001
         1000000000001
         1000000000001
         1000000000001
         1000000000001
         1000000000001
         1111111111111
