111111111111111111111111111111111
100000000000000000000000000000001
100N00000000000000000000000000D01
100000000000000000000000000000001
111111111100000000000111111111111
         1000000000001
1111111111000000000001
1000000000000000000001
100D000000000000000001
1000000000000000000001
1111111111000000000001
         1000000000001
         11110000011111111111111111
         10000000000000000000000001
         1000000000000000000000D001
         10000000000000000000000001
         10000000000011111111111111
         1000000000001
         1000LLLLL0001
         1000LLLLL0001
         1000LLLLL0001
         1000000000001
         1000000000001
         1000000000001
         1000000000001
         1000000000001
         1000000000001
         100000D000001
         1000000000001
         1111111111111