
        1111111111111111111111111
        1000000000110000000000001
        1011000001110000000000001
        1001000000000000000000001
111111111011000001110000000000001
100000000011000001110111110111111
11110111111111011100000010001
11110111111111011101010010001
11000000110101011100000010001
100000000000000011000000100011
1000000000000000110101001000001
11000001110101011111011110N00001
11110111 1110101 10111101000001
11111111 1111111 1111111111111