                              1111111111111111111111111111111111111111111111111111111111111
                              1000000000000000000000000000000000000000000000000000000000001
                              100E000000000000000000000000000000000000000000000000000000D01
                              1000000000000000000000000000000000000000000000000000000000001
                              1111111111111111100000000000111111111100000000000111111111111
                                              1000000000001        1000000000001
       1111111111111111111111111111111111111111000000000001        100000D000001
       1000000000000000000000000000000000000000000000000001        1000000000001
       100D0000000000000000D0000000000000000000000000000001        1111111111111
       1000000000000000000000000000000000000000000000000001
       1111111111111000000000001111111111111111000000000001
                 1000000000001                1000000000001
                 1000000000001                111100000111111111111111111111111111111111111
                 100000D000001                100000000000000000000000000000000000000000001
                 1000000000001                10000000000000000000000000000000000000000D001
                 1111111111111                100000000000000000000000000000000000000000001
                                              100000000000111111110000000000011111111111111
                                              1000000000001      1000000000001
                                              1000LLLLL0001      100000D000001
                                              1000LLLLL0001      1000000000001
                                              1000LLLLL0001      1111111111111
                                              1000000000001
                                              1000000000001
                                              1000000000001
                                              100000D000001
                                              1000000000001
                                              1111111111111
