111111111111111111111111111111111111111111111111111111111111111111111
100010001000000010001000D000000D00001000100000D00000000000D0000000001
1E00G0D0G000D000G0B0G000000000000000G000G0000000000000000000000000001
10001000100000001000100000D0000000001000100000000000D00000000000000D1
1111111111111111111111111111111111111LLL11111111111111111111111111111
                                    11111