11111111111111111111111111111111111111111111111111111111111111111111111111111111111
10000010000010000000100B00100000000000000000001000000010000000000000000000000000001
1000001000001000D000100000100000D00000000D000010000000100000D00000000000D0000000001
1E0000G00D00G0000000G00000G0000000000000000000G0000000G0000000000000000000000000001
1000001000001000D0001000001000000000D00000000010000000100000000000D00000000000D0001
10000010000010000000100D00100000000000000000001000000010000000000000000000000000001
1111111111111111111111111111111111111111111111111LLL1111111111111111111111111111111
                                                11111