1111111111
1000000001
1000S00001
1000000001
1000000001
1000B00001
1000000001
1000000001
1000000001
1000000001
1111111111